A #########
# #   #   #
# # # ### #
#   # # # #
### # # # #
#   #     #
# ##### # #
# #     # #
# # # ### #
#   #    B#
###########