#########################################
A   #   #   #       # # #     #     #   #
# # # ### ### # ##### # # ##### # ### # #
# #       #   #     #         # # # # # #
##### ### # # ##### # ##### ##### # # ###
# #   #     # #         #           #   #
# # ##### ### ######### ######### # # # #
#   #     # #   # #     #   #   # #   # #
##### ### # ##### # # # ### # ####### ###
#     # # #   #     # # # #             #
##### # # ### ##### # # # # ### ### #####
#     #         #   # # #   #   #       #
### # # ##### # ####### ########### # ###
#   # # #   # #   #   # # # # #   # #   #
# # ### # ####### # ##### # # # #########
# #   #   #   #       # # # #           #
############# ### # ### # # # # ### #####
#       # #       # #     #   #   #     #
##### # # ### ######### ### # ### ### # #
# #   # #   #             # # # # #   # #
# ##### ### ### ### ########### # # ### #
#       #       #       #       # #   # #
####### # ##################### ### #####
# #   # #   # #   #     # #       # #   #
# # # # # # # # # ### ### ####### # ### #
# # #     # #   #   # # # #     #     # #
# ##### # ##### ### # # # # ####### ### #
# #     #         # #     #   #   # #   #
# # ### ### ### ##### ##### ### # # # ###
#     #   # # # # # #     #     # #     #
# ##### # # # ### # ### ####### ### # ###
# # #   # #       # #   # #     #   # # #
# # # ### ##### # # ### # ### # # ### # #
# # # #   # # # #       # #   # #   #   #
# # # # ### # # ####### # ##### ##### # #
#   # #   # #   # # #       # #   # # # #
####### ### ##### # # ### ### # # # # ###
#       # #     #       #   #   #   #   #
# ##### # # ##### ##### ##### # # ### ###
# #           #     #         # #       B
#########################################